# bgn/pcgn 1981
ա	a
բ	b
գ	g
դ	d
ե	e
զ	z
է	e
ը	y
թ	t'
ժ	zh
ի	i
լ	l
խ	kh
ծ	ts
կ	k
հ	h
ձ	dz
ղ	gh
ճ	ch
մ	m
յ	y
ն	n
շ	sh
ո	o
չ	ch'
պ	p
ջ	j
ռ	rr
ս	s
վ	v
տ	t
ր	r
ց	ts'
փ	p'
ք	k'
օ	o
ֆ	f
և	ev
# other
ՠ	a
ւ	w
ֈ	ha
# symbols
ՙ	`
՚	'
՛	*
՜	!
՝	,
՞	?
՟	.
։	.
֊	-
֍	*
֎	*
