# https://unicode.org/charts/PDF/U11800.pdf
# https://unicode.org/L2/L2015/15234r-dogra.pdf
#
# Independent vowels
ЁСаА	рдЕ
ЁСаБ	рдЖ
ЁСаВ	рдЗ
ЁСаГ	рдИ
ЁСаД	рдЙ
ЁСаЕ	рдК
ЁСаЖ	рдП
ЁСаЗ	рдР
ЁСаИ	рдУ
ЁСаЙ	рдФ
# Consonants
ЁСаК	рдХ
ЁСаЛ	рдЦ
ЁСаМ	рдЧ
ЁСаН	рдШ
ЁСаО	рдЩ
ЁСаП	рдЪ
ЁСаР	рдЫ
ЁСаС	рдЬ
ЁСаТ	рдЭ
ЁСаУ	рдЮ
ЁСаФ	рдЯ
ЁСаХ	рда
ЁСаЦ	рдб
ЁСаЧ	рдв
ЁСаШ	рдг
ЁСаЩ	рдд
ЁСаЪ	рде
ЁСаЫ	рдж
ЁСаЬ	рдз
ЁСаЭ	рди
ЁСаЮ	рдк
ЁСаЯ	рдл
ЁСаа	рдм
ЁСаб	рдн
ЁСав	рдо
ЁСаг	рдп
ЁСад	рд░
ЁСае	рд▓
ЁСаж	рд╡
ЁСаз	рд╢
ЁСаи	рд╖
ЁСай	рд╕
ЁСак	рд╣
ЁСал	рд▒
# Dependent vowel signs
ЁСам	рд╛
ЁСан	рд┐
ЁСао	реА
ЁСап	реБ
ЁСа░	реВ
ЁСа▒	реГ
ЁСа▓	реД
ЁСа│	реЗ
ЁСа┤	реИ
ЁСа╡	реЛ
ЁСа╢	реМ
# Various signs
ЁСа╖	рдВ
ЁСа╕	рдГ
ЁСа╣	реН
ЁСа║	рд╝
# Punctuation
ЁСа╗	ре░
