# bgn/pcgn 2009
ა	a
ბ	b
გ	g
დ	d
ე	e
ვ	v
ზ	z
თ	t
ი	i
კ	k'
ლ	l
მ	m
ნ	n
ო	o
პ	p'
ჟ	zh
რ	r
ს	s
ტ	t'
უ	u
ფ	p
ქ	k
ღ	gh
ყ	q'
შ	sh
ჩ	ch
ც	ts
ძ	dz
წ	ts'
ჭ	ch'
ხ	kh
ჯ	j
ჰ	h
# other
ჱ	ey
ჲ	y
ჳ	w
ჴ	q
ჵ	ow
ჶ	f
ჷ	e
ჸ	'
ჹ	g
ჺ	'
ჽ	e
ჾ	"
ჿ	w
# punctuation
჻	:.