ᅠ	
ᅟ	
ᄋ	
㉧	
ᆞ	eu
ᆢ	ui
ᅀ	z
ᅙ	'
ᅌ	ye
ㆁ	ng
#
ᄼ	th
ᄽ	sh
ᄾ	x
ᄿ	zh
ᅎ	z
ᅏ	dz
ᅐ	j
ᅑ	dzh
ᅔ	c
ᅕ	q
# ssang
ᄙ	ll
ᇐ	ll
ᄔ	nn
ᅇ	hngw
ᇮ	hng
ᅘ	hh
ꥹ	tt
ꥼ	h'
ퟠ	mm
# kapyeoun
ᅗ	fh
ퟝ	lh
ᄛ	lh
ᄫ	v
ᄝ	hm
ᄬ	bh
