# ungegn 1982
саа	a
саб	e
сав	i
саг	o
сад	u
сае	o
саж	u
саи	n
сак	b
сал	p
сам	h
сан	g
сао	m
сап	l
са░	s
са▒	x
са▓	t
са│	d
са┤	q
са╡	j
са╢	y
са╖	r
са╕	w
са╣	f
са║	k
са╝	c
са╜	z
са╛	h
# knab 2015
саз	e
сай	ng
са╗	k
са┐	z
сбА	lh
сбБ	zh
сбВ	ch
# https://en.wikipedia.org/wiki/Clear_Script
сбД	e
сбЕ	i
сбЖ	o
сбЗ	u
сбИ	o
сбЙ	u
сбК	ng
сбЛ	b
сбМ	p
сбН	x
сбО	q
сбП	m
сбР	t
сбС	d
сбТ	ch
сбУ	z
сбФ	c
сбХ	y
сбЦ	w
сбЧ	kh
сбШ	k
сбЩ	g
сбЪ	j
# https://en.wikipedia.org/wiki/Transliterations_of_Manchu
# A Comprehensive Manchu-Chinese Dictionary
сбЭ	e
сбЮ	i
сбЯ	y
сба	u
сбб	uu
сбв	ng
сбг	k
сбд	g
сбе	h
сбж	p
сбз	sh
сби	t
сбй	d
сбк	zh
сбл	f
сбм	gg
сбн	hh
сбо	c
сбп	z
сб░	rr
сб▒	ch
сб▓	zh
сб│	i
сб┤	k
сб╡	r
сб╢	f
сб╖	zh
# punctuation
саА	@
саБ	...
саВ	,
саГ	.
саД	:
саЕ	*
саЖ	-
саЗ	+
саИ	,
саЙ	.
саК	'
# format controls
саЛ	
саМ	
саН	
саО	
# todo
сбГ	-
сбЫ	n
сбЬ	dz
# https://www.unicode.org/L2/L2017/17007-n4781-mongolian.pdf
сб╕	sh
# ali gali devanagari 
свЗ	a
свИ	i
свЙ	k
свК	n
свЛ	c
свМ	t
свН	th
свО	d
свП	n
свР	t
свС	d
свТ	p
свУ	ph
свФ	s
свХ	zh
свЦ	z
свШ	t
свЩ	zh
свЪ	gh
свЫ	n
свЬ	c
свЭ	jh
свЮ	t
свЯ	dh
сва	t
свб	dh
свв	s
свд	zh
све	z
сви	bh
свк	lh
# ali gali
свА	m
свБ	h
#свВ	
#свГ	
#свД	
свЕ	`
свЖ	```
свЧ	ah
свг	cy
свж	u
свз	y
#свй	
# punctuation
ЁСЩа	@
ЁСЩб	@
ЁСЩв	@
ЁСЩг	@
ЁСЩд	@
ЁСЩе	@
ЁСЩж	@
ЁСЩз	@
ЁСЩи	@
ЁСЩй	@
ЁСЩк	@
ЁСЩл	@
ЁСЩм	@
