# https://unicode.org/charts/PDF/U1E100.pdf
# https://unicode.org/wg2/docs/n4780r3-nyiakeng-puachue-hmong.pdf
#
# Consonant onsets
𞄀	m
𞄁	ts
𞄂	nt
𞄃	t
𞄄	h
𞄅	n
𞄆	x
𞄇	nk
𞄈	c
𞄉	l
𞄊	s
𞄋	z
𞄌	nc
𞄍	nts
𞄎	k
𞄏	d
𞄐	ny
𞄑	nr
𞄒	v
𞄓	ntx
𞄔	tx
𞄕	f
𞄖	r
𞄗	q
𞄘	y
𞄙	nq
𞄚	p
𞄛	xy
𞄜	np
𞄝	dl
𞄞	npl
𞄟	'
𞄠	ml
𞄡	pl
𞄢	g
𞄣	r
# Vowel rimes
𞄤	a
𞄥	aa
𞄦	i
𞄧	u
𞄨	o
𞄩	oo
𞄪	e
𞄫	ee
𞄬	w
# Tone marks
𞄰	b
𞄱	m
𞄲	j
𞄳	v
𞄴	s
𞄵	g
𞄶	d
# Determinatives
𞄷	
𞄸	
𞄹	
𞄺	
𞄻	
# Repetition mark
𞄼	-
# Syllable lengthener
𞄽	
# Symbols
𞅎	$
𞅏	@
