# https://www.unicode.org/charts/PDF/U10450.pdf
# https://en.wikipedia.org/wiki/Shavian_alphabet
#
# tall
𐑐	p
𐑑	t
𐑒	k
𐑓	f
𐑔	th
𐑕	s
𐑖	sh
𐑗	ch
𐑘	y
𐑙	ng
𐑚	b
𐑛	d
𐑜	g
𐑝	v
𐑞	th
𐑟	z
𐑠	zh
𐑡	j
𐑢	w
𐑣	h
# short
𐑤	l
𐑥	m
𐑦	i
𐑧	e
𐑨	a
𐑩	a
𐑪	o
𐑫	u
𐑬	au
𐑭	a
𐑮	r
𐑯	n
𐑰	i
𐑱	ei
𐑲	ai
𐑳	u
𐑴	ou
𐑵	u
𐑶	oi
𐑷	o
# ligatures
𐑸	𐑭𐑮
𐑹	𐑷𐑮
𐑺	er
𐑻	er
𐑼	𐑩𐑮
𐑽	𐑦𐑩𐑮
𐑾	𐑦𐑩
𐑿	𐑘𐑵
