# https://www.unicode.org/charts/PDF/U1950.pdf
# unicode consonants
ᥐ	k
ᥑ	x
ᥒ	ng
ᥓ	ts
ᥔ	s
ᥕ	y
ᥖ	t
ᥗ	th
ᥘ	l
ᥙ	p
ᥚ	ph
ᥛ	m
ᥜ	f
ᥝ	v
ᥞ	h
ᥟ	q
ᥠ	kh
ᥡ	tsh
ᥢ	n
# unicode vowels
ᥣ	a
ᥤ	i
ᥥ	ee
ᥦ	eh
ᥧ	u
ᥨ	oo
ᥩ	o
ᥪ	ue
ᥫ	e
ᥬ	aue
ᥭ	ai
# tones
ᥰ	
ᥱ	
ᥲ	
ᥳ	
ᥴ	
