# iso 15919
роГ	k
роЕ	a
роЖ	a
роЗ	i
роИ	i
роЙ	u
роК	u
роО	e
роП	e
роР	ai
роТ	o
роУ	o
роФ	au
роХ	k
роЩ	n
роЪ	c
роЬ	j
роЮ	n
роЯ	t
рог	n
род	t
рои	n
рой	n
рок	p
роо	m
роп	y
ро░	r
ро▒	r
ро▓	l
ро│	l
ро┤	l
ро╡	v
ро╢	s
ро╖	s
ро╕	s
ро╣	h
ро╛	a
ро┐	i
рпА	i
рпБ	u
рпВ	u
рпЖ	e
рпЗ	e
рпИ	ai
рпК	o
рпЛ	o
рпМ	au
# other
роВ	m
рпН	
рпР	Om
рпЧ	u
рп░	10
рп▒	100
рп▓	1000
рп│	d
рп┤	m
рп╡	y
рп╢	Dr
рп╖	Cr
рп╕	-
рп║	#
#ЁС┐А	_
#ЁС┐Б	_
#ЁС┐В	_
#ЁС┐Г	_
#ЁС┐Д	_
#ЁС┐Е	_
#ЁС┐Ж	_
#ЁС┐З	_
#ЁС┐И	_
#ЁС┐Й	_
#ЁС┐К	_
#ЁС┐Л	_
#ЁС┐М	_
#ЁС┐Н	_
#ЁС┐О	_
#ЁС┐П	_
#ЁС┐Р	_
#ЁС┐С	_
#ЁС┐Т	_
#ЁС┐У	_
#ЁС┐Ф	_
#ЁС┐Х	_
#ЁС┐Ц	_
#ЁС┐Ч	_
#ЁС┐Ш	_
#ЁС┐Щ	_
#ЁС┐Ъ	_
#ЁС┐Ы	_
#ЁС┐Ь	_
#ЁС┐Э	_
#ЁС┐Ю	_
#ЁС┐Я	_
#ЁС┐а	_
#ЁС┐б	_
#ЁС┐в	_
#ЁС┐г	_
#ЁС┐д	_
#ЁС┐е	_
#ЁС┐ж	_
#ЁС┐з	_
#ЁС┐и	_
#ЁС┐й	_
#ЁС┐к	_
#ЁС┐л	_
#ЁС┐м	_
#ЁС┐н	_
#ЁС┐о	_
#ЁС┐п	_
#ЁС┐░	_
#ЁС┐▒	_
#ЁС┐┐	_
